Do not touch the flames, and watch how they move.

....................
....................
..........X.........
.......######.......
..W..............W..
####..W.W...W...----
.......W.W.WBW......
......hhhhhhhh......
....-...........-...
....................
W..W............W.W.
####............####
....................
.1.........A........
#######..IIIIIIIIIII